4444444444444444
4000000000000004
4004444444444004
4004000000004004
4004000000000004
4004000000000004
4004444004444444
100:999008887777
100:000000000006
100:000000000006
100;008800008006
100;008800008005
10;;<<<888888005
1000000000000005
1000000000000004
1111122223333444